1
34 91 1
1234567890123456789012345678901234567890123456789012345678901234567890123456789012345678901
2        1         2         3         4         5         6         7         8         9 
3                                                                      ********************
4         *****************                                                                
5         *               *               *********                                        
6         *               *               *********                                        
7         *               *               *********                                        
8         *****************                *********                                       
9                                                                                          
01                                                      ****************************       
1                                                           **********************         
2                                                       ********************************   
3*********************     ***********************************************                 
4                                                        ************                      
5                                                           *                              
6                                                           *                              
7                                                           *                              
8                                                           *                              
9                                    *****                  *                              
02      *********                    ******       **************************               
1                                                                                          
2                                                                                          
3                                                                                          
4                               *    ******                 ***********                    
5                               *    ******                 *         *                    
6                               *    ******                 *         *              ******
7                               *    ******                ***        *                    
8                               *                          ***        *                    
9                               *                           *         *                    
03             ****             *                        *******CIREL *                    
1                               *                           *         *                    
2           *************************                      * *        *                    
3                                                         *   *       *                    
4                                                                   ********               