8
34 91 0
1234567890123456789012345678901234567890123456789012345678901234567890123456789012345678901
2        1         2         3         4         5         6         7         8         9 
3                                                                                          
4                                                                                          
5                                                                                          
6                                                       -------------+                     
7                                                       |            |                     
8                                                       |            |                     
9                                                       |            |                     
01                                                                   |                     
1                                                                    |                     
2                                                                    |                     
3                                                                    |                     
4                                                                    |                     
5     +---+---+---+---+---+---+---+---+                              |                     
6     |   |   |   |   |   |   |   |   |                              |                     
7     +---+---+---+---+---+---+---+---+                              |                     
8       1   2   3   4   5   6   7   8                                |                     
9                                                                    |                     
02                                                                   |                     
1                                                                    |                     
2                                                                    |                     
3                                                                    |                     
4                                                                    |                     
5                                                                    |                     
6                                                                    |                     
7                                                            -----------------             
8                                                            -----------------             
9                                                                                          
03                                                                                         
1                                                                                          
2                                                                                          
3                                                                                          
4                                                                                          
34 91 1
1234567890123456789012345678901234567890123456789012345678901234567890123456789012345678901
2        1         2         3         4         5         6         7         8         9 
3                                                                                          
4                                                                                          
5                                                                                          
6                                                       -------------+                     
7                                                       |            |                     
8                                                       |            |                     
9                                                       |            |                     
01                                                    *****          |                     
1                                                    *     *         |                     
2                                                    *     *         |                     
3                                                     *   *          |                     
4                                                      ***           |                     
5     +---+---+---+---+---+---+---+---+                              |                     
6     |   |   |   |   |   |   |   |   |                              |                     
7     +---+---+---+---+---+---+---+---+                              |                     
8       1   2   3   4   5   6   7   8                                |                     
9                                                                    |                     
02                                                                   |                     
1                                                                    |                     
2                                                                    |                     
3                                                                    |                     
4                                                                    |                     
5                                                                    |                     
6                                                                    |                     
7                                                            -----------------             
8                                                            -----------------             
9                                                                                          
03                                                                                         
1                                                                                          
2                                                                                          
3                                                                                          
4                                                                                          
34 91 2
1234567890123456789012345678901234567890123456789012345678901234567890123456789012345678901
2        1         2         3         4         5         6         7         8         9 
3                                                                                          
4                                                                                          
5                                                                                          
6                                                       -------------+                     
7                                                       |            |                     
8                                                       |            |                     
9                                                       |            |                     
01                                                    *****          |                     
1                                                    *     *         |                     
2                                                    *     *         |                     
3                                                     *   *          |                     
4                                                      ***           |                     
5     +---+---+---+---+---+---+---+---+                 *            |                     
6     |   |   |   |   |   |   |   |   |                 *            |                     
7     +---+---+---+---+---+---+---+---+                 *            |                     
8       1   2   3   4   5   6   7   8                   *            |                     
9                                                       *            |                     
02                                                      *            |                     
1                                                       *            |                     
2                                                       *            |                     
3                                                                    |                     
4                                                                    |                     
5                                                                    |                     
6                                                                    |                     
7                                                            -----------------             
8                                                            -----------------             
9                                                                                          
03                                                                                         
1                                                                                          
2                                                                                          
3                                                                                          
4                                                                                          
34 91 3
1234567890123456789012345678901234567890123456789012345678901234567890123456789012345678901
2        1         2         3         4         5         6         7         8         9 
3                                                                                          
4                                                                                          
5                                                                                          
6                                                       -------------+                     
7                                                       |            |                     
8                                                       |            |                     
9                                                       |            |                     
01                                                    *****          |                     
1                                                    *     *         |                     
2                                                    *     *         |                     
3                                                     *   *          |                     
4                                                      ***           |                     
5     +---+---+---+---+---+---+---+---+                 *            |                     
6     |   |   |   |   |   |   |   |   |                **            |                     
7     +---+---+---+---+---+---+---+---+              *  *            |                     
8       1   2   3   4   5   6   7   8               *   *            |                     
9                                                  *    *            |                     
02                                                      *            |                     
1                                                       *            |                     
2                                                       *            |                     
3                                                                    |                     
4                                                                    |                     
5                                                                    |                     
6                                                                    |                     
7                                                            -----------------             
8                                                            -----------------             
9                                                                                          
03                                                                                         
1                                                                                          
2                                                                                          
3                                                                                          
4                                                                                          
34 91 4
1234567890123456789012345678901234567890123456789012345678901234567890123456789012345678901
2        1         2         3         4         5         6         7         8         9 
3                                                                                          
4                                                                                          
5                                                                                          
6                                                       -------------+                     
7                                                       |            |                     
8                                                       |            |                     
9                                                       |            |                     
01                                                    *****          |                     
1                                                    *     *         |                     
2                                                    *     *         |                     
3                                                     *   *          |                     
4                                                      ***           |                     
5     +---+---+---+---+---+---+---+---+                 *            |                     
6     |   |   |   |   |   |   |   |   |                **            |                     
7     +---+---+---+---+---+---+---+---+              *  *            |                     
8       1   2   3   4   5   6   7   8               *   *            |                     
9                                                  *    *            |                     
02                                                      *            |                     
1                                                       *            |                     
2                                                       *            |                     
3                                                     *              |                     
4                                                    *               |                     
5                                                   *                |                     
6                                                                    |                     
7                                                            -----------------             
8                                                            -----------------             
9                                                                                          
03                                                                                         
1                                                                                          
2                                                                                          
3                                                                                          
4                                                                                          
34 91 5
1234567890123456789012345678901234567890123456789012345678901234567890123456789012345678901
2        1         2         3         4         5         6         7         8         9 
3                                                                                          
4                                                                                          
5                                                                                          
6                                                       -------------+                     
7                                                       |            |                     
8                                                       |            |                     
9                                                       |            |                     
01                                                    *****          |                     
1                                                    *     *         |                     
2                                                    *     *         |                     
3                                                     *   *          |                     
4                                                      ***           |                     
5     +---+---+---+---+---+---+---+---+                 *            |                     
6     |   |   |   |   |   |   |   |   |                ***           |                     
7     +---+---+---+---+---+---+---+---+              *  *  *         |                     
8       1   2   3   4   5   6   7   8               *   *   *        |                     
9                                                  *    *    *       |                     
02                                                      *            |                     
1                                                       *            |                     
2                                                       *            |                     
3                                                     *              |                     
4                                                    *               |                     
5                                                   *                |                     
6                                                                    |                     
7                                                            -----------------             
8                                                            -----------------             
9                                                                                          
03                                                                                         
1                                                                                          
2                                                                                          
3                                                                                          
4                                                                                          
34 91 6
1234567890123456789012345678901234567890123456789012345678901234567890123456789012345678901
2        1         2         3         4         5         6         7         8         9 
3                                                                                          
4                                                                                          
5                                                                                          
6                                                       -------------+                     
7                                                       |            |                     
8                                                       |            |                     
9                                                       |            |                     
01                                                    *****          |                     
1                                                    *     *         |                     
2                                                    *     *         |                     
3                                                     *   *          |                     
4                                                      ***           |                     
5     +---+---+---+---+---+---+---+---+                 *            |                     
6     |   |   |   |   |   |   |   |   |                ***           |                     
7     +---+---+---+---+---+---+---+---+              *  *  *         |                     
8       1   2   3   4   5   6   7   8               *   *   *        |                     
9                                                  *    *    *       |                     
02                                                      *            |                     
1                                                       *            |                     
2                                                       *            |                     
3                                                     *   *          |                     
4                                                    *     *         |                     
5                                                   *       *        |                     
6                                                                    |                     
7                                                            -----------------             
8                                                            -----------------             
9                                                                                          
03                                                                                         
1                                                                                          
2                                                                                          
3                                                                                          
4                                                                                          
34 91 7
1234567890123456789012345678901234567890123456789012345678901234567890123456789012345678901
2        1         2         3         4         5         6         7         8         9 
3                                                                                          
4                                                                                          
5                                                                                          
6                                                       -------------+                     
7                                                       |            |                     
8                                                       |            |                     
9                                                       |            |                     
01                                                    *****          |                     
1                                                    * o o *         |                     
2                                                    *  .  *         |                     
3                                                     * - *          |                     
4                                                      ***           |                     
5     +---+---+---+---+---+---+---+---+                 *            |                     
6     |   |   |   |   |   |   |   |   |                ***           |                     
7     +---+---+---+---+---+---+---+---+              *  *  *         |                     
8       1   2   3   4   5   6   7   8               *   *   *        |                     
9                                                  *    *    *       |                     
02                                                      *            |                     
1                                                       *            |                     
2                                                       *            |                     
3                                                     *   *          |                     
4                                                    *     *         |                     
5                                                   *       *        |                     
6                                                                    |                     
7                                                            -----------------             
8                                                            -----------------             
9                                                                                          
03                                                                                         
1                                                                                          
2                                                                                          
3                                                                                          
4                                                                                          